##########################################################################################################################################
#........................................................................................................................................#
#........................................................................................................................................#
#........................................................................................................................................#
#........................................................................................................................................#
#........................................................................................................................................#
#........................................................................................................................................#
#........................................................................................................................................#
#........................................................................................................................................#
#........................................................................................................................................#
#........................................................................................................................................#
#........................................................................................................................................#
#........................................................................................................................................#
#........................................................................................................................................#
#........................................................................................................................................#
#........................................................................................................................................#
#........................................................................................................................................#
#........................................................................................................................................#
#........................................................................................................................................#
#........................................................................................................................................#
#........................................................................................................................................#
#........................................................................................................................................#
#........................................................................................................................................#
#..............................++++++++++++++++++++++++++++++++..........................................................................#
#........................................................................................................................................#
#........................................................................................................................................#
#..........................########################################......................................................................#
#........................................................................................................................................#
#........................................................................................................................................#
#........................................................................................................................................#
#........................................................................................................................................#
#........................................................................................................................................#
#........................................................................................................................................#
#........................................................................................................................................#
#........................................................................................................................................#
..........................................................................................................................................




