..........................................................................................................................................
..........................................................................................................................................
..........................................................................................................................................
..........................................................................................................................................
..........................................................................................................................................
..........................................................................................................................................
..........................................................................................................................................
..........................................................................................................................................
................................................................???????????????????.......................................................
..........................................................................................................................................
................................................................................................................................??????????
......???????????.........................................................................................................................
..........................................................................................................................................
..........................................................................................................................................
..........................................................................................................................................
..........................................................................................................................................
..........................................................................................................................................
..........................................................................................................................................
...........................................................................................??????????????.................................
..............................??????????..................................................................................................
..........................................................................................................................................
..........................................................................................................................................
..........................................................................................................................................
..........................................................................................................................................
..............................................................????????????????............................................................
..........................................................................................................................................
???????????????...........................................................................................................................
..........................................................................................................................................
..........................................................................................................................................
.......................................................................................................................??????????.........
..........................................................................................................................................
...............................????????????????...........................................................................................
..........................................................................................................................................
??????????????????????????????????????????????????????????????????????????????????????????????????????????????????????????????????????????
..........................................................................................................................................
..........................................................................................................................................




