##########################################################################################################################################
#........................................................................................................................................#
#........................................................................................................................................#
#........................................................................................................................................#
#........................................................................................................................................#
#........................................................................................................................................#
#........................................................................................................................................#
#........................................................................................................................................#
#...................#....................................................................................................................#
#..................#.#...................................................................................................................#
#.................#...#..................................................................................................................#
#................#.....#.................................................................................................................#
#...............#.......#................................................................................................................#
#..............#.........#...............................................................................................................#
#.............#...........#..............................................................................................................#
#............#.............#.............................................................................................................#
#...........#...............#.................................................................................#......#...................#
#..........#.................#...............................................................................#.#....#.#..................#
#.........#...................#...............................................................................#......#...................#
#........#.....................#.........................................................................................................#
#.......#.......................#........................................................................................................#
#......#.........................#...............................................................................##......................#
#......#.........................#......................................................................#........##........#.............#
#......#.........................#.......................................................................#................#..............#
#......#.........................#........................................................................##............##...............#
#......#.........................#..........................................................................###......###.................#
#......#.........................#.............................................................................######....................#
#......#.........................#.......................................................................................................#
#......#.........................#.......................................................................................................#
#......#...........######........#.......................................................................................................#
#......#...........#....#........#.......................................................................................................#
#......#...........#....#........#.......................................................................................................#
#......#...........#.#..#........#.......................................................................................................#
#......#...........#....#........#.......................................................................................................#
#......#...........#....#........#.......................................................................................................#
##########################################################################################################################################

