..........................................................................................................................................
..........................................................................................................................................
..........................................................................................................................................
..........................................................................................................................................
............................???????.......................................................................................................
..........................................................................................................................................
..........................................................................................................................................
..........................................................................................................................................
................................................................???????????????????.......................................................
..........................................................................................................................................
..........................................................................................................................................
......???????????..................................................................................................????????????...........
..........................................................................................................................................
..........................................................................................................................................
..........................................................................................................................................
..........................................................................................................................................
..........................................................................................................................................
..........................................................................................................................................
...........................................................................................??????????????.................................
..............................??????????..................................................................................................
..........................................................................................................................................
..........................................................................................................................................
..........................................................................................................................................
..........................................................................................................................................
..............................................................????????????................................................................
.................................................................................................................?????????................
......?????????.........................................................................................?????????.........................
...............................................................................................?????????..................................
......................................................................................?????????...........................................
.............................................................................?????????.................................??????????.........
....................................................................?????????.............................................................
...............................????????????????...........................................................................................
..........................................................................................................................................
??????????????????????????????????????????????????????????????????????????????????????????????????????????????????????????????????????????
++++++++++++++++++++++++++++++++++++++++++++++++++++++++++++++++++++++++++++++++++++++++++++++++++++++++++++++++++++++++++++++++++++++++++
++++++++++++++++++++++++++++++++++++++++++++++++++++++++++++++++++++++++++++++++++++++++++++++++++++++++++++++++++++++++++++++++++++++++++




